字段类型
StringField	普通文本字段
PasswordField	密码框
SubmitField	提交按钮
TextAreaField	多行文本域
HiddenField	隐藏域
DateField	日期
DateTimeField	日期时间
IntegerField	整形
FloatField	浮点型
RadioField	单选字段
SelectField	下拉
FileField	文件上传字段
BooleanField	布尔字段

验证器
DataRequired	必填
Length	长度 min max
IPAddress	IP地址
Email	邮箱
URL	地址
Regexp	正则匹配
EqualTo	验证俩个字段值的正确性
NumberRange	输入值的范围 min max